23 23
00000000000000000000000
01111111111111111111000
01000000010000000001000
01000001111111000001000
00000001111111000001000
01111101111111000001000
01111101111111000001000
01111101111111110001000
01111100011100010001000
01111100011111111101000
01111100000001111101000
01111111110111111111000
01000000000111111101000
01111111110111111101110
00000000010111111100010
01111111011111111100010
01111111010000000000010
01111111010111111100010
01111111010100000100010
01111111010100010100010
00010000010100010100010
01111111111100011111110
00000000000000000000000
