127 127
0000000000000000000000000000000000000000000000000000000000000000000000000000000000000000000000000000000000000000000000000000000
0111111111111111111100000000000000011111110111111111110111110111111100000111111100000000011111110111111111111111111111111111000
0111110100000101111100000000000000011111110100010000010111110111111100000100000100000000011111110000010000000000000000000001000
0111110111111101111111000001000000011111110100010111011111110111111101111111011101111111011111111111110111111111110111111101000
0001000101111101111111000001000000011111110100010100000001000111111101111111011101111111011111010111110111111100010111111101000
0111111101111101111111111101000000011111110100010111111111011111111101111111111101111111011111010111110111111111110111111101000
0111111101111101111100011101000000011111110100010101111111010111111101111100011101111111010000010111110111110001110111111101000
0111111101111101111101111111111111111111110101010101111111010111111101111111011101111111111111111111110111110111111111111101000
0111110000010000000001111111011111000001000101010101111111000100000001111101000000011111011111110111110001000001110111111101000
0111111101111111111101111111011111000111111101010101111111011111111111111101110000011111011111110111110001111101110111111101000
0000000101111111000100011111010100000111110001010001111100011111110000010000010000010000011111110000000001111100000000000001000
0111111101111111000111011111010111110111111101011101111111111111110111111101110000011111111111110111111111111101111111111111000
0111111101111111000001000101010111110111111101000100000000011111110111111100010000011111011111010100010111111101000001011111000
0111111101111111000001011101010111111111111101011111111101111111111111111101111111111111011111011111010111111101000111011111000
0111111101111111000001010000010111110111110001011111110101000101000111110101111111011111000000011111010111111101000100000111000
0111111101111111000001011111110111110111111111011111110101111111110111110101111111011111111100011111110111111101000111110111000
0101000100000000000001011111110100000000000000011111110100000100000111000001111111011111000100011111000000000001000111110001000
0101011111111111111101011111110111111101111111011111110111111101110111011111111111011111110100011111011111111111000111110111000
0100011111110111111101011111110111000101000001011111000111110001010000011100011111000001010100000100011111000000000111110111000
0111111111110111111101011111110111011111011111011111000111111101111111011111011111011111010101111101111111111111110111110111110
0000011111110111111101011111110111000000010000000100000111111101111111011111000000011111010101111101010000011111110111110111010
0111011111110111111101011111111111011111010000011100000111111111111111111111011111111111010111111101011111011111111111110111010
0111010000000101111101000001000001011111010000000000000000000001111111011111010001111111010111111101011111011111110100000111010
0111111101111101111101111101111111011111110101111111111111111111111111011111010111111111011111111101011111111111110111111111010
0111111101111100000101111101110000011111110101111111011111110100011111000001010101111101000111110001011111010111110000000100010
0111111111111100000111111101110000011111110111111111011111110101011111011111110101111101110111110111011111010111110111111100010
0000000101111100000111111100000000000111110101111111011111110101000100011111110100000001110000000100011111010000000111111100010
0111111101111111110111111111111111110111110101111111011111110101111111111111110111110111111111111100011111110111111111111111110
0111110000010001110111111101111100010100000001111100010111000101111111000100000000010111110001000000000000000111110111111100010
0111111111111111110111111101111111011101111111111101110111111101111111011100011111011111110111111111111111110111110111111101110
0111110111111100010001010001111111011101111100000001110000000001111111010000011111000111110111111101111111010111110111111101000
0111110111111101111111011111111111011101111100000111110111111101111111011111111111110111111111111101111111011111110111111101000
0111110111111101111111000001111111011101111100000101110111111100011100011111011111110000000111111101111111000001000000000001000
0111110111111111111111011101111111011101111100000101111111111100011100011111011111110000000111111101111111111111110101111101000
0100000001111101111111011101000001000000000100000100000001110000000100011111000111110000000111111100000001011111110101111101000
0111111111111101111111011111110111111101111111111100011101110111111101111111011111110111110111111100000001011111111111111101000
0100000000000001111101011111110101111101111111011100010100010111111101011111010000000100010001000000000001011111110101110001000
0101000001111101111101011111110111111101111111011100010111011111111101011111011111110111011111110111000001011111110101110101000
0101000001111100000001011111110001111101111111011100010001010111111100000000000000000100000001000101000001011111110100000101000
0111000111111111111111011111110001111101111111011101111111010111111111110111111111111101111101011111111101011111110111000101000
0001000111111100010000000000000001111101111111011101111100010111111101110111110000000001111101011111110101010000000101000101000
0111111111111111010000000111111101111111111111011111111111010111111101110111111101111111111101011111110111110001111101111101000
0111110111111101010000000111111100000000000000000001111111010000000000000111111101111101111101011111110000000001010000000001000
0111110111111101010111111111111111111101110111011111111111011111111111110111111101111101111101111111111111110001010111111101000
0111110000000000010111110111110001111100010111010001111111011111000000010001111101111100000100000111110111110001010111111101000
0111111111011111111111110111111101111111010111111101111111011111111111011101111101111101110111110111110111111101010111111101000
0000000001011111000111110111110101111111010111111100010000000000011111011101000001000101010111110000000111111101010111111101000
0111111101011111111111110111111111111111010111111111111111111101011111011111110111110111110111111101110111111101010111111101000
0111111101011111110001110001000000011111010111111100010111111101011111011111110111110111110111111101110111111101010111111101000
0111111101011111110101110111111100011111011111111111110111111101011111011111111111110111111111111101110111111101010111111101000
0111111101011111110100000111111100000000000000000000000111111101010111011111000111110111110111110001110100010001010000010001000
0111111111011111110111110111111111111111111111111100000111111101110111011111110111110111110111110001110101111111011111110001000
0000000100000100000100010111111100000000000000000100000101111101110001000100010111110101000000000001010101111111000000010001000
0101111111111111110111110111111100000001111111110111111101111111110111110111110111110101111100011111010101111111011111010001110
0101111111011111110111110001110100000001000100010111111100010001110111110111110001000100000100010000010101111111011111010000010
0111111111011111111111111101110101111101111111110111111100010111110111110111111111110111110111111111010111111111011111110000010
0101111100000000000111111101010101111101011111110111111100010100000001110111110111110111110000000000010000011111011111110000010
0101111101111111110111111101010101111111011111110111111101111111011101111111110111110111110001111111011111111111011111110111110
0101111101111100010001110001010101111101011111110001000001111111011101110001110111110111110001111111011111000000011111110100000
0101111101111111111101110111010101111101011111110111111101111111111111110001110111110111111101111111011111111111011111110111110
0100000001111100000100000100010101111101000111010100000001111111011100010001000111000100000101111111011111110100000100000000010
0101111101111100011101011111010101111101110111011101111101111111011111111111110111000111110101111111111111110111111100000111010
0101111100010000011101011111010100000000000000010101111101000001000001111101110100000111110101111100010111110000010000000111010
0101111111111111011111111111010111111111111111010101111111010111110111111101110100000111111101111111010111111111010111111111010
0101111100011111011111011111010111110000000111010101111111010111110001111101110100000111110100000001000001000001000111110111010
0101111111111111011111011111011111110111111111110101111111010111111111111101110111111111110101011111110101111101011111110111110
0100000001111111011111000001000111110111011111110100011111010111111100000000000111110001000101011111110101111101011111110111010
0111111111111111111111000001110111110111011111110111011111010111111100011111011111111111110111011111110111111101111111110111010
0111111101111111010100000000000000000111011111110101000100010111110000011111000111110111110000011111110000000100011111000000000
0111111101111111010111111101110000000111011111110101111111110111111111111111111111110111111101111111110000011111011111000000000
0111111100000001010000000101110000000100000001000100000000010000000111011111110111110111111101011111010000011111000000000000000
0111111111110111111101110101111111011111110001000101111111011111110111011111110111110111111111011111011111011111011111110000000
0100000000010111111100010101111111011111110001000101111111000000010111011111000001000111111100000100011111011111010111110000000
0101111111010111111111110101111111011111110001000101111111000000010111011111111111111111111101111101111111011111011111111111110
0101111111010111111100010100011100011111110001000101111111000000010100000001011111110001000001111101111111011111010000000001010
0101111111010111111101110111111100011111110001111101111111000000010111110111011111110001000001111111111111011111010001111101010
0101111111010111111100010000000100011111110000000001111101000000010000010000011111110001000001011101111111010100010001111101010
0101111111011111111101111111111100011111110000011101111111011101111111011111111111110111000111011101111111011100010111111111010
0101111100010101000001111101111100000000010000011100010100010101111111000001000111000100000100000000000101000000010111111100010
0111111100010101111101111101111111111111110000011111110111011101111111011111110111011101111111110111111101011111110111111111010
0100000000010101111101111101111111011111010000010111110111011101111111011111110100010001111111010111111101010000000111111101010
0111110000010101111111111101111111011111010111110111110111111111111111011111110111110001111111010111111101011111110111111101010
0111110000000101111101110001111111011111010111110111000111011100011111011111110100000001111111010111111101000111110000000100010
0111110111111101111101111111111111011111010111110111011111011100011111011111110101111111111111010111111111000111111100011111010
0000010100000000000100000100010000011100000111110001000000000000000101011111000001111100011111010111111100000111111100011111010
0000010111111111111111010101111111011101111111110111111100000000011101111111011111111100011111010111111100000111111100011111010
0000010000000000011111010101111111000001000111110101111100000000011100000001010001111100010000010100000100000101110000011100010
0111010111011111011111110101111111111111110111110101111101111111111101111111011101111100011111011111110111110101110000011101110
0111010111011111000001000101111100000000000000000101111101111111000001111111000101110000000001011111110111110100000000000001010
0111011111011111110001111101111101111111011111011101111111111111111101111111000101110111110111011111110111110111011111110001010
0111011111011111110001000001110001111111011111010000000000011111011101111111000100000111110101011111110000000100011111110001010
0111011111011111110111000001111101111111011111011111111111011111011101111111000111111111110101011111110111111101111111110001010
0111011111011111110100000000000101111101011111000000011111011111011101000100000000000111110101000111000100010001011111110001010
0111011111011111110101111111011111111101011111011111111111011111011101111111111100000111110101110111111111011111011111110001010
0001000001010000000101111111011100000100000100000101111111000000010000000000000100000001110100000100011111011111011111010000010
0001111111011111110101111111011111011111110111111101111111011111011111110111111100000001110111111101011111011111011111011111110
0001111111011111110101111111011111011111110101000101111100011111011111110111111100000000010000000001011111011111000001010000010
0001111111011111111101111111011111011111111101011101111111111111111111110111111111111111110111111101011111011111011111110111110
0001111111011111110100011111000111011111110001010001000001011111011111110111111101111111010111111101000000010000000000000000000
0001111111011111110111011111000111011111110001010001111101011111011111110111111101111111010111111111111101111111011111011111110
0001000000011111010000010100000001011111110001010001111100000000011111110111111101111111010111111100000101111111011111011111010
0001000000011111011111110101111111011111111111011101111111111111011111110111111101111111010111111101110101111111011111011111010
0001000000000100011111110100010000000000000111000100000000000001000000000001000001111100010001111101110101111111011111011111010
0001000111111100011111110101111111011111111111110100000111111101111111111111111101111100010101111101111101111111011111111111010
0001000101111100011111110101111111000000000111110100000111111100000001000001111100000100010100000101110001000000011100011111010
0001000101111100011111110101111111011111111111110111110111111111111101111111111111111101110111111101110001111111111100011111010
0001000001111100000111110101111111011111110000010000010111111101110100000001111101111101000001000000000000000000000000000000010
0111111101111101111111111101111111011111110001111101110111111101110111011111111101111111000001000000011111110111111111111100010
0111111101110001000001000001111111011111110001111100010111110001110001011100000100000001000001000000010000010100010000000100010
0111111111110111111111111101111111011111110001111111010111110101111101011111011101111101111111000000011111011111011111011111010
0111111100010100000001111100010000011111110000011111010000010101000101011111010001111100011100000000011111011111011111011111010
0111111101010101111101111111111111111111110000011111010111011111110101111111011111111111111111111111011111011111011111011111010
0111111101010001111101000001111111000000000000011111010100011111110100000001000000011111011100011111011111011111011100011111010
0111111111011111111111111101111111110001111111011111011111111111110111011111110000011111011101111111111111011111011101011111110
0000000100000001111111000101111111010001111111010000011111000111110001011111110000011111011101111111011100000000000001011111010
0111111101111101111111000101111111010001111111111111011111110111110101011111110000011111011101111111011100000000011111011111110
0111111101000101111111000101010000010000011100011111011111110100000101011111110000000001010001111100010100000000011111000000010
0111111101010101111111011101011111110000011101111111111111110111110111111111110000000111111101111100010111111111011111110111110
0111111101010101000000010000011111000000000001011111011111110111110000011100010000000111111101000000010001111111011111110100000
0111111101010111111111111111011111111111111111011111011111111111111111111100011111111111111101111111011111111111011111110101110
0001111101010111111101111111011111110111110100000000000100000111110111000000011111110111111101111111010001111111011111110101010
0111111101010111111101111111111111110111110100000111111101110111110111110111111111110111111111111111010001111111111111110101010
0100000101010001111101111101011111000111000000000111111100010100010111110100011111110001000001111111010001111101000000000101010
0101000101111101111101111101011111000111011111110111111101111101010111111111011111110111011111111111010001111101111111110101010
0101000100000101010000000000000000000000010000010000000001000001010000000000000000000001010000000000010000000000000000010100010
0111000111111101111111111111111111111111110000011111111111000001111111111111111111111111011111111111110000000000000000011111110
0000000000000000000000000000000000000000000000000000000000000000000000000000000000000000000000000000000000000000000000000000000
